

NO ./xpm/north.xpm

SO ./xpm/south.xpm

WE ./xpm/west.xpm
EA ./xpm/east.xpm

F 220,100,0
C 225,30,0
11111111111111111111111
1100100000111000000001
1001111000111000000011
100111100011100000111111
1001100000000000000111
E111111111111111111111111
